1111111111111111111111111111111111111111
1000000000000000000000000000000000000001
1000000000000000000000000000000000000001
1000000000000000000000000000000000000001
1000000000000000000000000000000000000001
1000020000200000000000000000020000200001
1000020000200000000000000000020000200001
1000020000200000000000000000020000200001
1000020000200000000000000000020000200001
1000011111100000000000000000011111100001
1000000000000000000000000000000000000001
1000000000000000000000000000000000000001
1000000000000000000000000000000000000001
1000000000022222200000022222200000000001
1000000000020000200000020000200000000001
1000000000020000200000020000200000000001
1000000000020000200000020000200000000001
1000000000022222200000022222200000000001
1000000000000000000000000000000000000001
1000000000000000000000000000000000000001
1000000000000000000000000000000000000001
1000000000000000000000000000000000000001
1000000000022222200000022222200000000001
1000000000020000200000020000200000000001
1000000000020000200000020000200000000001
1000000000020000200000020000200000000001
1000000000022222200000022222200000000001
1000000000000000000000000000000000000001
1000000000000000000000000000000000000001
1000000000000000000000000000000000000001
1000000002000002000000002000002000000001
1000000020000020000000000200000200000001
1000000200000200000000000020000020000001
1000002000002000000000000002000002000001
1000002222220000000000000000222222000001
1000000000000000000000000000000000000001
1000000000000000000000000000000000000001
1000000000000000000000000000000000000001
1000000000000000000000000000000000000001
1111111111111111111111111111111111111111